/* Level 5 */

@GHOST_STEP_RATE 0.3

#########################
#@.....................o#
#.# ##..###...###..##.#.#
#.#.....ooooooooo.....#.#
<...##..oX##O##Xo..##...>
#.#.....ooooooooo.....#.#
#.#.##..###...###..##.#.#
#o.....................o#
#########################
