/* Level 10 */

@GHOST_PADDING_RATE 0.2

#######################
# #.#.#.#.o.#.#.#.#.#.#
#.#.#.#.#.#.#.o.#.#.#.#
#@o.#.<.#.#.#.#.>.#.#.#
#.#.o.#.#.#.#.#.#.#.#.#
#.#.#.#.o.#.o...#.o.o.#
#######################
